999999999999999999999999999999
921111111111111111111111111129
910000000000000000000000000019
910000000000000000000000000019
910000000000000000000000000019
910000000000000000000000000019
910000000000000000000000000019
910000000000000000000000000019
910000000000000000000000000019
910000000000000000000000000019
910000000000000000000000000019
910000000000000000000000000019
910000000000000000000000000019
910000000000000000000000000019
910000000000000000000000000019
910000000000000000000000000019
910000000000000000000000000019
910000000000000000000000000019
910000000000000000000000000019
910000000000000000000000000019
910000000000000000000000000019
910000000000000000000000000019
910000000000000000000000000019
910000000000000000000000000019
910000000000000000000000000019
910000000000000000000000000019
910000000000000000000000000019
910000000000000000000000000019
921111111111111111111111111129
999999999999999999999999999999
5
5
3
1
300000