999999999999999999999999999999
921111111111111111111111111129
910000000000000000000000000019
910000000000000000000000000019
910000000000000000000000000019
910000000000000000000000000019
910000000111111111111000000019
910000000000000000000000000019
910000000000000000000000000019
910000000000000000000000000019
910000001000000000000100000019
910000001000000000000100000019
910000001000000000000100000019
910000001000000000000100000019
910000001000000000000100000019
910000001000000000000100000019
910000001000000000000100000019
910000001000000000000100000019
910000001000000000000100000019
910000001000000000000100000019
910000000000000000000000000019
910000000000000000000000000019
910000000000000000000000000019
910000000111111111111000000019
910000000000000000000000000019
910000000000000000000000000019
910000000000000000000000000019
910000000000000000000000000019
921111111111111111111111111129
999999999999999999999999999999
20
30
10
8
25000