999999999999999999999999999999
921111111111111111111111111129
910000000000000000000000000019
910000000000000000000000000019
910000000000000000000000000019
910000000000000000000000000019
921111110000000000000011111129
910000010000000000000010000019
910000010000000000000010000019
910000010000000000000010000019
910000010000000000000010000019
910000011100000000001110000019
910000000000000000000000000019
910000000000000000000000000019
910000000000000000000000000019
910000000000000000000000000019
910000000000000000000000000019
910000000000000000000000000019
910000011100000000001110000019
910000010000000000000010000019
910000010000000000000010000019
910000010000000000000010000019
910000010000000000000010000019
921111110000000000000011111129
910000000000000000000000000019
910000000000000000000000000019
910000000000000000000000000019
910000000000000000000000000019
921111111111111111111111111129
999999999999999999999999999999
50
50
30
15
30000