999999999999999999999999999999
921111111111111111111111111129
910000000000000000000000000019
910000000000000000000000000019
910000000000000000000000000019
910000000000001000000000000019
910000000000001000000000000019
910000000000001000000000000019
910000000000001000000000000019
910000000000001000000000000019
910000000000001000000000000019
910000000000000000000000000019
910000000000000000000000000019
910000000000000000000000000019
910000000000000000000000000019
910000000000000000000000000019
910000000000000000000000000019
910000000000000000000000000019
910000000000000000000000000019
910000000000001000000000000019
910000000000001000000000000019
910000000000001000000000000019
910000000000001000000000000019
910000000000001000000000000019
910000000000001000000000000019
910000000000000000000000000019
910000000000000000000000000019
910000000000000000000000000019
921111111111111111111111111129
999999999999999999999999999999
10
7
5
2
200000