999999999999999999999999999999
921111111111112211111111111129
910000000000001100000000000019
910000000000001100000000000019
910000000000001100000000000019
910000000000001100000000000019
910000000111111111111000000019
910000000000000000000000000019
910000000000000000000000000019
910000000000000000000000000019
910000000000000000000000000019
921111111111111000000000000019
910000000000000000000000000019
910000000000000000000000000019
910000000000000000000000000019
910000000000000000000000000019
910000000000000000000000000019
910000000000000000000000000019
910000000000000111111111111129
910000000000000000000000000019
910000000000000000000000000019
910000000000000000000000000019
910000000000000000000000000019
910000000111111111111000000019
910000000000001100000000000019
910000000000001100000000000019
910000000000001100000000000019
910000000000001100000000000019
921111111111112211111111111129
999999999999999999999999999999
30
40
20
10
40000